"WWWWWWWWWWWWWWWWWWWW",
"W........i.........W",
"W...P..............W",
"W.....i..WWWW...B..W",
"W...........W......W",
"W.....D.....W..G...W",
"WWWWWW......W......W",
"W...........W..T...W",
"WIIIIWWWWWWWW......W",
"W..................W",
"WWWWWWWWWWWWWWWWWWWW"