"WWWWWWWWWWWWWWWWWWWW",
"W..................W",
"W...P..............W",
"W........WWWW......W",
"W...........W......W",
"W.....D.....W..G...W",
"WWWWWW......W......W",
"W...........W..T...W",
"W....WWWWWWWW......W",
"W..................W",
"WWWWWWWWWWWWWWWWWWWW"