WWWWW
WSWWW
WLWlW
W.W.W
WkWKW
W.W.W
WJWIW
W.W.W
WiWjW
W.W.W
W.P.W
WWWWW