WWWWWWWWWWW
WSWWWWWWWWW
W....J...WW
WWWWWW.W.WW
W....WJWJWW
W.WW.W.WGWW
W.W..I.WWWW
W.W.WW.WGWW
W.WIGW..IWW
W.WWWWWWWWW
WP...i..jWW
WWWWWWWWWWW