"SWWWWWWWW",
"....J...W",
"WWWWW.W.W",
"....WJWJW",
".WW.W.WMW",
".W..I.WWW",
".W.WW.WMW",
".WIMW..IW",
".WWWWWWWW",
"P....i.jW"